+  +--+--+--+
|0 |3  4  5 |
+  +  +--+  +
|1  2 |9 |6 |
+--+--+  +  +
|     |8  7 |
+  +--+  +--+
|      10 11|
+--+--+--+  +