+  +--+--+--+
|# |#  #  # |
+  +  +--+  +
|#  # |  |# |
+--+--+  +  +
|     |#  # |
+  +--+  +--+
|      #  # |
+--+--+--+  +