+  +--+--+--+--+--+
|0 |8  6  7  9 |12|
+  +--+  +--+  +  +
|1  2 |5 |  |10 11|
+--+  +  +  +--+  +
|  |3  4 |     |13|
+  +--+--+  +  +  +
|           |  |14|
+  +  +--+--+--+  +
|  |     |17 16 15|
+  +--+  +  +--+--+
|     |20 18 19 21|
+--+--+--+--+--+  +