+  +--+--+--+--+--+
|0 |   6  7  8 |11|
+  +--+  +--+  +  +
|1  2 |5 |  |9  10|
+--+  +  +  +--+  +
|  |3  4 |     |12|
+  +--+--+  +  +  +
|           |  |13|
+  +  +--+--+--+  +
|  |     |16 15 14|
+  +--+  +  +--+--+
|     |   17 18 19|
+--+--+--+--+--+  +