+  +--+--+--+--+--+
|# |   #  #  # |  |
+  +--+  +--+  +  +
|#  # |# |  |#  # |
+--+  +  +  +--+  +
|  |#  # |     |# |
+  +--+--+  +  +  +
|           |  |# |
+  +  +--+--+--+  +
|  |     |#  #  # |
+  +--+  +  +--+--+
|     |   #  #  # |
+--+--+--+--+--+  +