+  +--+--+--+--+--+--+--+
|#  # |#  #  #  #  # |  |
+--+  +  +--+--+--+  +  +
|  |#  # |        |#  # |
+  +--+--+  +--+--+--+  +
|           |#  #  #  # |
+  +--+--+  +  +--+--+--+
|     |     |#  #  # |  |
+--+--+  +  +--+--+  +  +
|        |     |  |#  # |
+  +--+--+--+  +  +--+  +
|  |              |#  # |
+  +  +--+--+--+  +  +--+
|  |  |        |  |#  # |
+  +--+  +--+  +--+--+  +
|           |         # |
+--+--+--+--+--+--+--+  +