+  +--+--+--+--+--+--+--+
|0  1 |4  5  6  7  8 |11|
+--+  +  +--+--+--+  +  +
|  |2  3 |        |9  10|
+  +--+--+  +--+--+--+  +
|           |15 14 13 12|
+  +--+--+  +  +--+--+--+
|     |     |16 17 18|21|
+--+--+  +  +--+--+  +  +
|        |     |  |19 20|
+  +--+--+--+  +  +--+  +
|  |              |23 22|
+  +  +--+--+--+  +  +--+
|  |  |        |  |24 25|
+  +--+  +--+  +--+--+  +
|           |         26|
+--+--+--+--+--+--+--+  +